111133333333331111
110032000030430001
100040000030430001
100033330033430001
300000030030000003
300000030030000003
30;000040040002203
300000033330000003
300000000000000003
302220000400000003
104440000000200001
102220000000400411
111333333333331111
