1111111111111111111111111111111111111111111111111111111111111
1000000000000000000000000000000000000000000000000000000000001
1000000000000000000000000000000000000000000000000000000000001
1001411411411411411411411411411411411411411411411411411411001
1000000000000000000000000000000000000000000000000000000000001
1001411411411411411411411411411411411411411411411411411411001
1000000000000000000000000000000000000000000000000000000000001
1001411411411411411411411411411411411411411411411411411411001
1000000000000000000000000000000000000000000000000000000000001
1001411411411411411411411411411411411411411411411411411411001
1000000000000000000000000000000000000000000000000000000000001
1001411411411411411411411411411411411411411411411411411411001
1000000000000000000000000000000000000000000000000000000000001
1001411411411411411411411411411411411411411411411411411411001
1000000000000000000000000000000000000000000000000000000000001
1001411411411411411411411411411411411411411411411411411411001
1000000000000000000000000000000000000000000000000000000000001
1001411411411411411411411411411411411411411411411411411411001
1000000000000000000000000000000000000000000000000000000000001
1001411411411411411411411411411411411411411411411411411411001
1000000000000000000000000000000000000000000000000000000000001
1001411411411411411411411411411411411411411411411411411411001
1000000000000000000000000000000000000000000000000000000000001
1001411411411411411411411411411411411411411411411411411411001
1000000000000000000000000000000000000000000000000000000000001
1001411411411411411411411411411411411411411411411411411411001
1000000000000000000000000000000000000000000000000000000000001
1001411411411411411411411411411411411411411411411411411411001
1000000000000000000000000000000000000000000000000000000000001
1001411411411411411411411411411411411411411411411411411411001
1000000000000000000000000000000000000000000000000000000000001
1001411411411411411411411411411411411411411411411411411411001
1000000000000000000000000000000000000000000000000000000000001
1001411411411411411411411411411411411411411411411411411411001
1000000000000000000000000000000000000000000000000000000000001
1001411411411411411411411411411411411411411411411411411411001
1000000000000000000000000000000000000000000000000000000000001
1000000000000000000000000000000000000000000000000000000000001
1111111111111111111111111111111111111111111111111111111111111
