77771117777111
7;000006555507
71111103500097
10000003500091
10003333505091
70003655005007
70006000050027
70006055500007
10206068888487
70000060000007
77711177771177
